444444444444444444448
472222222245552222248
422222222242662222248
422222522242222222248
422222222242222622248
422222255545552222248
422226662222222222248
422222222242222222248
422555222242262222248
422255222242666222248
422225222242222220048
422222222242222220148
444444444444444444449
